Cindy Louemba	Poitiers 3 Cités	3
Senagla Koukponou	Poitiers 3 Cités	1
Coralie Bertrand	ESA Brive	2
Maëlle Lelievre	FCC Oradour	2
Nawelle Benhebba	FCC Oradour	1
Manon Lienhart	FCC Oradour	1
Anaïs Couratin	FCC Oradour	5
Chelsea Copeman	US Nantiat	2
Mélina Ha	US Nantiat	2
Hayet Taleb	US Nantiat	1
Drissia Palas	US Nantiat	1
Rebecca Croizard	Poitiers 3 Cités	1
Anaïs Merigout	Poitiers 3 Cités	1
Alisson Beaulieu	Poitiers 3 Cités	1
Agathe Felden	Poitiers 3 Cités	1
Massecilia Aït-Ouarab	FCC Oradour	1
Nadia Péré	US Nantiat	1
Alexane Bureau	ES Guérêt	3
Marion Martel	ESA Brive	1
Annabelle Hardy Pouyade	ESA Brive	2
Emilie Ceyrat	ESA Brive	2
Sandy Hebrard	ESA Brive	1
Lucie Géraud	ESA Brive	1
Elise Moutineau	ESA Brive	1
Noémie Goix	ES Guérêt	1
Joanne Bobier	ES Guérêt	1
Aurélia Guillon	Niort St Florent	2
Houleye Ba	Niort St Florent	1
Anaïs Mertz	La Souterraine	2
Amandine Deniaud	La Souterraine	1
Augustine Laurent	La Souterraine	1
Laure Boissou	FCC Oradour	1