Alyssia Moyan	Bussac Forêt	2
Clarisse Delannoy	Bussac Forêt	3
Sandra Bernard	Bussac Forêt	4
Laura Gauthier	UES Montmorillon	3
Jessica Caloin	Limoges Football	6
Marie Cécile Lionet	Limoges Football	1
Serena Pinto De Queiros	Chamois Niortais	8
Ilona Deherripon	Chamois Niortais	3
Magali Lelievre	Chamois Niortais	1
Justine Michonneau	Chamois Niortais	3
Coraline Freland	Chamois Niortais	2
Laura Lemarquand	Chamois Niortais	1
Axelle Graveleau	Chamois Niortais	1
Maëva Amirault	Chatellerault SO	4
Ines Kefif	Chatellerault SO	1
Carole Flageul	Chatellerault SO	1
Orane Croizard	Poitiers 3 Cités	5
Justine Deschamps	Poitiers 3 Cités	1
Manon Chabanas Defrance	ASJ Soyaux	1
Lina Plasse	ASJ Soyaux	1
Juliette Belsoeur	Poitiers 3 Cités	1
Justine Baucher	Poitiers 3 Cités	1
Laurine Bruyère	Chatellerault SO	1
Delphine Cottineau	UES Montmorillon	1
Prescilla Campa	UES Montmorillon	1
Noélie Morsanic	Trélissac FC	3
Latifah Abdu	ASJ Soyaux	4
Laura Camus	ASJ Soyaux	2
Audrey Bernard	Chatellerault SO	1
Margot Gellé	FC Bressuire	1
Marion Richard	Bussac Foret	2
Célie Gautier	Poitiers 3 Cités	2
Mila Bodin	Poitiers 3 Cités	1
Astrid Audoux	Poitiers 3 Cités	1
Virginie Gaudriaud	Poitiers 3 Cités	1
Cindy David	UES Montmorillon	1
Justine Prézeau	Chamois Niortais	2
Manon Garguel	Limoges Football	2
Laura Lépine	Limoges Football	1